{
  "cube_size": [ 1.0, 1.0, 1.0 ],
  "material": {
    "normal": {
      "ambient": [ 0.7, 0.7, 0.7, 1.0 ],
      "diffuse": [ 0.7, 0.7, 0.7, 1.0 ],
      "specular": [ 0.9, 0.9, 0.9, 1.0 ],
      "shininess": 80.0,
      "emission": [ 0.0, 0.0, 0.0, 0.0 ]
    },
    "shrink": {
      "ambient": [ 0.7, 0.0, 0.0, 1.0 ],
      "diffuse": [ 0.7, 0.0, 0.0, 1.0 ],
      "specular": [ 0.9, 0.0, 0.0, 1.0 ],
      "shininess": 80.0,
      "emission": [ 0.0, 0.0, 0.0, 0.0 ]
    }
  },

  "cube_type": [
    [
      [ 0, 0, 0, 0, 0, 0, 0, 0, 0, 0 ],
      [ 0, 0, 0, 0, 0, 0, 0, 0, 0, 0 ],
      [ 0, 0, 0, 0, 0, 0, 0, 0, 0, 0 ],
      [ 0, 0, 0, 0, 0, 0, 0, 0, 0, 0 ],
      [ 0, 0, 0, 0, 1, 1, 0, 0, 0, 0 ],
      [ 0, 0, 0, 0, 1, 1, 0, 0, 0, 0 ],
      [ 0, 0, 0, 0, 0, 0, 0, 0, 0, 0 ],
      [ 0, 0, 0, 0, 0, 0, 0, 0, 0, 0 ],
      [ 0, 0, 0, 0, 0, 0, 0, 0, 0, 0 ],
      [ 0, 0, 0, 0, 0, 0, 0, 0, 0, 0 ]
    ],
    [
      [ -1, -1, -1, -1, -1, -1, -1, -1, -1, -1 ],
      [ -1, -1, -1, -1, -1, -1, -1, -1, -1, -1 ],
      [ -1, -1, -1, -1, -1, -1, -1, -1, -1, -1 ],
      [ -1, -1, -1, -1, -1, -1, -1, -1, -1, -1 ],
      [ -1, -1, -1, -1, -1, -1, -1, -1, -1, -1 ],
      [ -1, -1, -1, -1, -1, -1, -1, -1, -1, -1 ],
      [ -1, -1, -1, -1, -1, -1, -1, -1, -1, -1 ],
      [ -1, -1, -1, -1, -1, -1, -1, -1, -1, -1 ],
      [ -1, -1, -1, -1, -1, -1, -1, -1, -1, -1 ],
      [ -1, -1, -1, -1, -1, -1, -1, -1, -1, -1 ]
    ],
    [
      [ -1, -1, -1, -1, -1, -1, -1, -1, -1, -1 ],
      [ -1, -1, -1, -1, -1, -1, -1, -1, -1, -1 ],
      [ -1, -1, -1, -1, -1, -1, -1, -1, -1, -1 ],
      [ -1, -1, -1, -1, -1, -1, -1, -1, -1, -1 ],
      [ -1, -1, -1, -1, -1, -1, -1, -1, -1, -1 ],
      [ -1, -1, -1, -1, -1, -1, -1, -1, -1, -1 ],
      [ -1, -1, -1, -1, -1, -1, -1, -1, -1, -1 ],
      [ -1, -1, -1, -1, -1, -1, -1, -1, -1, -1 ],
      [ -1, -1, -1, -1, -1, -1, -1, -1, -1, -1 ],
      [ -1, -1, -1, -1, -1, -1, -1, -1, -1, -1 ]
    ],
    [
      [ -1, -1, -1, -1, -1, -1, -1, -1, -1, -1 ],
      [ -1, -1, -1, -1, -1, -1, -1, -1, -1, -1 ],
      [ -1, -1, -1, -1, -1, -1, -1, -1, -1, -1 ],
      [ -1, -1, -1, -1, -1, -1, -1, -1, -1, -1 ],
      [ -1, -1, -1, -1, -1, -1, -1, -1, -1, -1 ],
      [ -1, -1, -1, -1, -1, -1, -1, -1, -1, -1 ],
      [ -1, -1, -1, -1, -1, -1, -1, -1, -1, -1 ],
      [ -1, -1, -1, -1, -1, -1, -1, -1, -1, -1 ],
      [ -1, -1, -1, -1, -1, -1, -1, -1, -1, -1 ],
      [ -1, -1, -1, -1, -1, -1, -1, -1, -1, -1 ]
    ],
    [
      [ -1, -1, -1, -1, -1, -1, -1, -1, -1, -1 ],
      [ -1, -1, -1, -1, -1, -1, -1, -1, -1, -1 ],
      [ -1, -1, -1, -1, -1, -1, -1, -1, -1, -1 ],
      [ -1, -1, -1, -1, -1, -1, -1, -1, -1, -1 ],
      [ -1, -1, -1, -1, -1, -1, -1, -1, -1, -1 ],
      [ -1, -1, -1, -1, -1, -1, -1, -1, -1, -1 ],
      [ -1, -1, -1, -1, -1, -1, -1, -1, -1, -1 ],
      [ -1, -1, -1, -1, -1, -1, -1, -1, -1, -1 ],
      [ -1, -1, -1, -1, -1, -1, -1, -1, -1, -1 ],
      [ -1, -1, -1, -1, -1, -1, -1, -1, -1, -1 ]
    ],
    [
      [ -1, -1, -1, -1, -1, -1, -1, -1, -1, -1 ],
      [ -1, 0, 0, 0, 0, 0, 0, 0, 0, -1 ],
      [ -1, 0, 0, 0, 0, 0, 0, 0, 0, -1 ],
      [ -1, 0, 0, 0, 0, 0, 0, 0, 0, -1 ],
      [ -1, 0, 0, 0, 0, 0, 0, 0, 0, -1 ],
      [ -1, 0, 0, 0, 0, 0, 0, 0, 0, -1 ],
      [ -1, 0, 0, 0, 0, 0, 0, 0, 0, -1 ],
      [ -1, 0, 0, 0, 0, 0, 0, 0, 0, -1 ],
      [ -1, 0, 0, 0, 0, 0, 0, 0, 0, -1 ],
      [ -1, -1, -1, -1, -1, -1, -1, -1, -1, -1 ]
    ]
  ],

  "_0": {
    "_4": {
      "_4": {
        "shrink_value": [ 0.0, 2.0, 0.0 ],
        "is_shrink": false,
        "take_time": 2.0
      },
      "_5": {
        "shrink_value": [ 0.0, 2.0, 0.0 ],
        "is_shrink": false,
        "take_time": 1.0
      }
    },

    "_5": {
      "_4": {
        "shrink_value": [ 0.0, 2.0, 0.0 ],
        "is_shrink": false,
        "take_time": 1.0
      },
      "_5": {
        "shrink_value": [ 0.0, 2.0, 0.0 ],
        "is_shrink": false,
        "take_time": 2.0
      }
    }
  }
}
